1 13 31
###############################
#p     ** *    *   *  * * *   #
# # # #*# # #*#*# # # #*#*#*# #
#   *     ***  *      *1  * * #
# # # # # #*# # #*#*# # # #1#*#
#f         x **  *  *1        #
# # # # # # # # # #*# #*# # # #
#*  *      *  *      *        #
# # # # #*# # # #*#*# # # # # #
#*    **  *  1 1  *           #
# #*# # # # # # #*# # # # # # #
#           *   *  *          #
###############################
0
1 1 1 1 2 false false false false true